24
111111111111111111111111
101000001000100000000000
101010101010111110111110
101010100010000010001000
101010111111111011111011
100010100010001000001000
101110101010111111101110
100010001010001000101000
111011111010101010101010
100010001010101010001010
101110101011101011111010
001000100010001010000010
011011111110111010111110
000010000000100010100000
111111111110101110111011
100000000000101000001010
101011111111101111101010
101000000000001000001000
101111111111111011111110
101000100000001010000010
101010111011101011101110
000010100010101010001000
011110101110101010111011
000000001000000010000000;


