24
000000000000000000000000
011111011111111110111110
010000000000000000000010
010111110111111011111010
010100000000000000001010
010101111101101111101010
000101000000000000101010
010101010111111010101010
010001000000000000100010
010101010111011010101010
010100010100001010001000
010101010001101010101010
010101010101100010101010
010100010100001010001000
010101010110111010101010
010001000000000000100010
010101010111111010101010
000101000000000000101010
010101111101101111101010
010100000000000000001010
010111110111111011111010
010000000000000000000010
011111011111111110111110
000000000000000000000000;